	 ####################################
	###--------------------------------###
	#------------------------------------#
	#------------------------------------#
	#------------------------------------#
	#------------------------------------#
	#---------------#######--------------#
	#---------------#######--------------#
	#---------------##-------------------#
	#---------------##-------------------#
	#-------##########--########---------#
	#------------#####--##-@-###---------#
	#--------------###--##-$-------------#
	###-------------##--##-------------###
	 ####################################